border_size=1
usage=map

Wo          , Wo          , Wo          , Wo          , Wo          , Wo          , Wo          , Wo          , Wo          , Wo          , Wo          , Wo          , Wo          , Wo          , Wo          , Wo          , Wo          , Wo          , Wo          , Wo          , Wo          , Wo          , Wo          , Wo          , Wo          , Wo          , Wo          , Wo          , Wo          , Wo          , Wo          , Wo          , Wo          , Wo          , Wo          , Wo          , Wo          , Wo          , Wo          , Wo          , Wo          , Wo          , Wo          
Wo          , Wo          , Wo          , Wo          , Wo          , Wo          , Wo          , Wo          , Wo          , Wo          , Wo          , Wo          , Wo          , Wo          , Wo          , Wo          , Wo          , Wo          , Wo          , Wo          , Wo          , Wo          , Wo          , Wo          , Wo          , Wo          , Wo          , Wo          , Wo          , Wo          , Wo          , Wo          , Wo          , Wo          , Wo          , Wo          , Wo          , Wo          , Wo          , Wo          , Wo          , Wo          , Wo          
Wo          , Wo          , Wo          , Wo          , Wo          , Wo          , Wo          , Wo          , Wo          , Wo          , Wo          , Wo          , Wo          , Wo          , Wo          , Wo          , Wo          , Wo          , Wo          , Wo          , Wo          , Wo          , Wo          , Wo          , Wo          , Wo          , Wo          , Wo          , Wo          , Wo          , Wo          , Wo          , Wo          , Wo          , Wo          , Wo          , Wo          , Wo          , Wo          , Wo          , Wo          , Wo          , Wo          
Wo          , Wo          , Wo          , Wo          , Wo          , Wo          , Wo          , Wo          , Wo          , Wo          , Wo          , Wo          , Wo          , Wo          , Wo          , Wo          , Wo          , Wo          , Wo          , Wo          , Wo          , Wo          , Wo          , Wo          , Wo          , Wo          , Wo          , Wo          , Wo          , Wo          , Wo          , Wo          , Wo          , Wo          , Wo          , Wo          , Wo          , Wo          , Wo          , Wo          , Wo          , Wo          , Wo          
Wo          , Wo          , Wo          , Wo          , Wo          , Wo          , Wo          , Wo          , Wo          , Wo          , Wo          , Wo          , Wo          , Wo          , Wo          , Wo          , Wo          , Wo          , Wo          , Wo          , Wo          , Wo          , Wo          , Wo          , Wo          , Wo          , Wo          , Wo          , Wo          , Wo          , Wo          , Wo          , Wo          , Wo          , Wo          , Wo          , Wo          , Wo          , Wo          , Wo          , Wo          , Wo          , Wo          
Wo          , Wo          , Wo          , Wo          , Wo          , Wo          , Wo          , Wo          , Wo          , Wo          , Wo          , Wo          , Wo          , Wo          , Wo          , Wo          , Wo          , Wo          , Wo          , Wo          , Wo          , Wo          , Wo          , Wo          , Wo          , Wo          , Wo          , Wo          , Wo          , Wo          , Wo          , Wo          , Wo          , Wo          , Wo          , Wo          , Wo          , Wo          , Wo          , Wo          , Wo          , Wo          , Wo          
Wo          , Wo          , Wo          , Wo          , Wo          , Wo          , Wo          , Wo          , Wo          , Wo          , Wo          , Wo          , Wo          , Wo          , Wo          , Wo          , Wo          , Wo          , Wo          , Wo          , Wo          , Wo          , Wo          , Wo          , Wo          , Wo          , Wo          , Wo          , Wo          , Wo          , Wo          , Wo          , Wo          , Wo          , Wo          , Wo          , Wo          , Wo          , Wo          , Wo          , Wo          , Wo          , Wo          
Wo          , Wo          , Wo          , Wo          , Wo          , Wo          , Wo          , Wo          , Wo          , Wo          , Wo          , Wo          , Wo          , Wo          , Wo          , Wo          , Wo          , Wo          , Wo          , Wo          , Wo          , Wo          , Wo          , Wo          , Wo          , Wo          , Wo          , Wo          , Wo          , Wo          , Wo          , Wo          , Wo          , Wo          , Wo          , Wo          , Wo          , Wo          , Wo          , Wo          , Wo          , Wo          , Wo          
Wo          , Wo          , Wo          , Wo          , Xu          , Xu          , Xu          , Xu          , Xu          , Xu          , Xu          , Xu          , Xu          , Xu          , Xu          , Xu          , Xu          , Xu          , Xu          , Xu          , Xu          , Xu          , Xu          , Xu          , Xu          , Xu          , Xu          , Xu          , Xu          , Xu          , Xu          , Xu          , Xu          , Xu          , Xu          , Xu          , Xu          , Xu          , Xu          , Wo          , Wo          , Wo          , Wo          
Wo          , Wo          , Wo          , Wo          , Xu          , Ce          , Dd          , Dd          , Hd          , Md          , Gg          , Uu^Ii       , Gg          , Uu^Vud      , Chs         , Gg          , Hh          , Xu          , Gg          , Gg          , Uu          , 1 Uu^Ii     , Uu          , Gg          , Gg          , Xu          , Hh          , Gg          , Chs         , Uu^Vud      , Gg          , Uu^Ii       , Gg          , Md          , Hd          , Dd          , Dd          , Ce          , Xu          , Wo          , Wo          , Wo          , Wo          
Wo          , Wo          , Wo          , Wo          , Xu          , Rr          , Dd^Do       , Dd          , Dd^Vdt      , Gg          , Gg          , Gg          , Uu^Uf       , Gg          , Ss          , Gg          , Gg          , Xu          , Gs^Fp       , Hh^Vhh      , Gg          , Gg          , Gg          , Hh^Vhh      , Gs^Fp       , Xu          , Gg          , Gg          , Ss          , Gg          , Uu^Uf       , Gg          , Gg          , Gg          , Dd^Vdt      , Dd          , Dd^Do       , Rr          , Xu          , Wo          , Wo          , Wo          , Wo          
Wo          , Wo          , Wo          , Wo          , Xu          , Rr          , Dd          , Dd          , Gg          , Gg          , Gs^Fp       , Re          , Gg          , Gg          , Ss^Vhs      , Uu^Uf       , Gg          , Xu          , Gg          , Uu^Uf       , Gg          , Gg          , Gg          , Uu^Uf       , Gg          , Xu          , Gg          , Uu^Uf       , Ss^Vhs      , Gg          , Gg          , Re          , Gs^Fp       , Gg          , Gg          , Dd          , Dd          , Rr          , Xu          , Wo          , Wo          , Wo          , Wo          
Wo          , Wo          , Wo          , Wo          , Xu          , Rr          , Rr          , Gg          , Gs^Fp       , Gg          , Gg          , Gg          , Gg          , Gg          , Gg          , Ss          , Chw         , Xu          , Ww          , Gg          , Gs^Fp       , Ch          , Gs^Fp       , Gg          , Ww          , Xu          , Chw         , Ss          , Gg          , Gg          , Gg          , Gg          , Gg          , Gg          , Gs^Fp       , Gg          , Rr          , Rr          , Xu          , Wo          , Wo          , Wo          , Wo          
Wo          , Wo          , Wo          , Wo          , Xu          , Gs          , Rr          , Gg          , Gg          , Gg^Ve       , Hh          , Gg          , Gs^Fp       , Hh          , Ww          , Ww          , Wwf         , Xu          , Wo          , Ww          , Ww          , Chw         , Ww          , Ww          , Wo          , Xu          , Wwf         , Ww          , Ww          , Hh          , Gs^Fp       , Gg          , Hh          , Gg^Ve       , Gg          , Gg          , Rr          , Gs          , Xu          , Wo          , Wo          , Wo          , Wo          
Wo          , Wo          , Wo          , Wo          , Xu          , Gs^Ft       , Gs          , Rr          , Hh          , Gg          , Rd          , Gg          , Wwf         , Wwf         , Ww          , Ww^Vm       , Wwf         , Xu          , Ww          , Ww          , Ww^Vm       , Wwf         , Ww^Vm       , Ww          , Ww          , Xu          , Wwf         , Ww^Vm       , Ww          , Wwf         , Wwf         , Gg          , Rd          , Gg          , Hh          , Rr          , Gs          , Gs^Ft       , Xu          , Wo          , Wo          , Wo          , Wo          
Wo          , Wo          , Wo          , Wo          , Xu          , Ww          , Ww^Vm       , Rr          , Ww          , Ww          , Ww^Bw|      , Ww          , Wwf         , Wwf         , Gg          , Ww          , Gg          , Xu          , Gg          , Gg          , Ce          , Wwf         , Ce          , Gg          , Gg          , Xu          , Gg          , Ww          , Gg          , Wwf         , Wwf         , Ww          , Ww^Bw|      , Ww          , Ww          , Rr          , Ww^Vm       , Ww          , Xu          , Wo          , Wo          , Wo          , Wo          
Wo          , Wo          , Wo          , Wo          , Xu          , Ww          , Ww          , Wwf         , Gg          , Gg          , Rd          , Gg          , Rr          , Gg          , Gg          , Gg^Ve       , Gg          , Xu          , Dd^Vda      , Gg          , Gg          , Gg          , Gg          , Gg          , Dd^Vda      , Xu          , Gg          , Gg^Ve       , Gg          , Gg          , Rr          , Gg          , Rd          , Gg          , Gg          , Wwf         , Ww          , Ww          , Xu          , Wo          , Wo          , Wo          , Wo          
Wo          , Wo          , Wo          , Wo          , Xu          , Ww          , Gs^Vht      , Rr          , Gg          , Gg          , Gg          , Gg          , Rr          , Gg          , Hh          , Gg          , Gs^Ft       , Xu          , Xu          , Hd          , Xu          , Gs^Ft       , Xu          , Hd          , Xu          , Xu          , Gs^Ft       , Gg          , Hh          , Gg          , Rr          , Gg          , Gg          , Gg          , Gg          , Rr          , Gs^Vht      , Ww          , Xu          , Wo          , Wo          , Wo          , Wo          
Wo          , Wo          , Wo          , Wo          , Xu          , Hh          , Gs          , Rr          , 2 Kh        , Ch          , Ch          , Gs^Fp       , Ch          , Ch          , 3 Kh        , Gg          , Qxu         , Xu          , Wo          , Xu          , Wo          , Xu          , Wo          , Xu          , Wo          , Xu          , Qxu         , Gg          , 4 Kh        , Ch          , Ch          , Gs^Fp       , Ch          , Ch          , 5 Kh        , Rr          , Gs          , Hh          , Xu          , Wo          , Wo          , Wo          , Wo          
Wo          , Wo          , Wo          , Wo          , Wo          , Xu          , Xu          , Xu          , Xu          , Ch          , Xu          , Xu          , Xu          , Ch          , Xu          , Xu          , Xu          , Xu          , Wo          , Wo          , Wo          , Wo          , Wo          , Wo          , Wo          , Xu          , Xu          , Xu          , Xu          , Ch          , Xu          , Xu          , Xu          , Ch          , Xu          , Xu          , Xu          , Xu          , Wo          , Wo          , Wo          , Wo          , Wo          
Wo          , Wo          , Wo          , Wo          , Wo          , Wo          , Wo          , Wo          , Wo          , Xu          , Wo          , Wo          , Wo          , Xu          , Wo          , Wo          , Wo          , Wo          , Wo          , Wo          , Wo          , Wo          , Wo          , Wo          , Wo          , Wo          , Wo          , Wo          , Wo          , Xu          , Wo          , Wo          , Wo          , Xu          , Wo          , Wo          , Wo          , Wo          , Wo          , Wo          , Wo          , Wo          , Wo          
Wo          , Wo          , Wo          , Wo          , Wo          , Wo          , Wo          , Wo          , Wo          , Wo          , Wo          , Wo          , Wo          , Wo          , Wo          , Wo          , Wo          , Wo          , Wo          , Wo          , Wo          , Wo          , Wo          , Wo          , Wo          , Wo          , Wo          , Wo          , Wo          , Wo          , Wo          , Wo          , Wo          , Wo          , Wo          , Wo          , Wo          , Wo          , Wo          , Wo          , Wo          , Wo          , Wo          
