border_size=1
usage=map

Mm^Xm       , Mm^Xm       , Mm^Xm       , Mm^Xm       , Ch          , Mm^Xm       , Ch          , Mm^Xm       , Ch          , Mm^Xm       , Mm^Xm       , Mm^Xm       , Mm^Xm       , Mm^Xm       , Ch          , Mm^Xm       , Ch          , Mm^Xm       , Ch          , Mm^Xm       , Mm^Xm       , Mm^Xm       , Mm^Xm       , Mm^Xm       , Ch          , Mm^Xm       , Ch          , Mm^Xm       , Ch          , Mm^Xm       , Mm^Xm       , Mm^Xm       , Mm^Xm       
Mm^Xm       , Mm^Xm       , Mm^Xm       , Mm^Xm       , Ch          , Mm^Xm       , 1 Kh        , Mm^Xm       , Ch          , Mm^Xm       , Mm^Xm       , Mm^Xm       , Mm^Xm       , Mm^Xm       , Ch          , Mm^Xm       , 2 Kh        , Mm^Xm       , Ch          , Mm^Xm       , Mm^Xm       , Mm^Xm       , Mm^Xm       , Mm^Xm       , Ch          , Mm^Xm       , 3 Kh        , Mm^Xm       , Ch          , Mm^Xm       , Mm^Xm       , Mm^Xm       , Mm^Xm       
Mm^Xm       , Mm^Xm       , Mm^Vhh      , Gs          , Gs          , Mm^Xm       , Mm^Xm       , Mm^Xm       , Gs          , Aa^Vha      , Aa^Fpa      , Mm^Xm       , Aa^Fpa      , Aa^Vha      , Gs          , Mm^Xm       , Mm^Xm       , Mm^Xm       , Gs          , Aa^Vha      , Aa^Fpa      , Mm^Xm       , Aa^Fpa      , Aa^Vha      , Gs          , Mm^Xm       , Mm^Xm       , Mm^Xm       , Gs          , Gs          , Mm^Vhh      , Mm^Xm       , Mm^Xm       
Mm^Xm       , Mm^Xm       , Mm^Xm       , Uu          , Cud         , Ch          , Ha^Vhha     , Ch          , Ce          , Wwf         , Wwf         , Mm^Xm       , Wwf         , Wwf         , Ce          , Ch          , Ha^Vhha     , Ch          , Ce          , Wwf         , Wwf         , Mm^Xm       , Wwf         , Wwf         , Ce          , Ch          , Ha^Vhha     , Ch          , Cud         , Uu          , Mm^Xm       , Mm^Xm       , Mm^Xm       
Ww          , Ww          , Ww          , Mm^Xm       , Mm^Xm       , Wwf         , Wwf         , Wwf         , Mm^Xm       , Mm^Xm       , Mm^Xm       , Mm^Xm       , Mm^Xm       , Mm^Xm       , Mm^Xm       , Wwf         , Wwf         , Wwf         , Mm^Xm       , Mm^Xm       , Mm^Xm       , Mm^Xm       , Mm^Xm       , Mm^Xm       , Mm^Xm       , Wwf         , Wwf         , Wwf         , Mm^Xm       , Mm^Xm       , Ww          , Ww          , Ww          
Wo          , Wo          , Wo          , Ww          , Mm^Xm       , Uu^Uf       , Wwf         , Gs^Fp       , Mm^Xm       , Ww          , Ww          , Ww          , Ww          , Ww          , Mm^Xm       , Uu^Uf       , Wwf         , Gs^Fp       , Mm^Xm       , Ww          , Ww          , Ww          , Ww          , Ww          , Mm^Xm       , Uu^Uf       , Wwf         , Gs^Fp       , Mm^Xm       , Ww          , Wo          , Wo          , Wo          
Wo          , Wo          , Wo          , Ww          , Mm^Xm       , Gs          , Wwf         , Hh^Vhh      , Mm^Xm       , Ww          , Wo          , Wo          , Wo          , Ww          , Mm^Xm       , Gs          , Wwf         , Hh^Vhh      , Mm^Xm       , Ww          , Wo          , Wo          , Wo          , Ww          , Mm^Xm       , Gs          , Wwf         , Hh^Vhh      , Mm^Xm       , Ww          , Wo          , Wo          , Wo          
Wo          , Wo          , Wo          , Ww          , Mm^Xm       , Gs^Vht      , Ww^Bw|      , Mm          , Mm^Xm       , Ww          , Wo          , Wo          , Wo          , Ww          , Mm^Xm       , Gs^Vht      , Ww^Bw|      , Mm          , Mm^Xm       , Ww          , Wo          , Wo          , Wo          , Ww          , Mm^Xm       , Gs^Vht      , Ww^Bw|      , Mm          , Mm^Xm       , Ww          , Wo          , Wo          , Wo          
Wo          , Wo          , Wo          , Ww          , Mm^Xm       , Gs^Ft       , Wwf         , Gs          , Mm^Xm       , Ww          , Wo          , Wo          , Wo          , Ww          , Mm^Xm       , Gs^Ft       , Wwf         , Gs          , Mm^Xm       , Ww          , Wo          , Wo          , Wo          , Ww          , Mm^Xm       , Gs^Ft       , Wwf         , Gs          , Mm^Xm       , Ww          , Wo          , Wo          , Wo          
Wo          , Wo          , Ww          , Ww          , Mm^Xm       , Gs^Ft       , Mm^Xm       , Gs^Vht      , Mm^Xm       , Ww          , Ww          , Wo          , Ww          , Ww          , Mm^Xm       , Gs^Ft       , Mm^Xm       , Gs^Vht      , Mm^Xm       , Ww          , Ww          , Wo          , Ww          , Ww          , Mm^Xm       , Gs^Ft       , Mm^Xm       , Gs^Vht      , Mm^Xm       , Ww          , Ww          , Wo          , Wo          
Ww          , Ww          , Mm^Xm       , Mm^Xm       , Re^Gvs      , Mm^Xm       , Mm          , Mm^Xm       , Uu^Uf       , Mm^Xm       , Mm^Xm       , Ww          , Mm^Xm       , Mm^Xm       , Re^Gvs      , Mm^Xm       , Mm          , Mm^Xm       , Uu^Uf       , Mm^Xm       , Mm^Xm       , Ww          , Mm^Xm       , Mm^Xm       , Re^Gvs      , Mm^Xm       , Mm          , Mm^Xm       , Uu^Uf       , Mm^Xm       , Mm^Xm       , Ww          , Ww          
Mm^Xm       , Mm^Xm       , Gs          , Gs          , Gs^Ft       , Gs          , Gs          , Mm          , Gs^Ft       , Ss          , Chs         , Mm^Xm       , Gs          , Gs          , Gs^Ft       , Gs          , Gs          , Mm          , Gs^Ft       , Ss          , Chs         , Mm^Xm       , Gs          , Gs          , Gs^Ft       , Gs          , Gs          , Mm          , Gs^Ft       , Ss          , Chs         , Mm^Xm       , Mm^Xm       
Mm^Xm       , Mm^Xm       , Gs          , Gs^Ft       , Gs          , Gs          , Gs          , Gs          , Ss^Vm       , Ss          , Ss          , Mm^Xm       , Gs          , Gs^Ft       , Gs          , Gs          , Gs          , Gs          , Ss^Vm       , Ss          , Ss          , Mm^Xm       , Gs          , Gs^Ft       , Gs          , Gs          , Gs          , Gs          , Ss^Vm       , Ss          , Ss          , Mm^Xm       , Mm^Xm       
Mm^Xm       , Mm^Xm       , Dd^Do       , Gs          , Gs          , Rd          , Gs          , Gs          , Ww          , Ss          , Ww          , Mm^Xm       , Dd^Do       , Gs          , Gs          , Rd          , Gs          , Gs          , Ww          , Ss          , Ww          , Mm^Xm       , Dd^Do       , Gs          , Gs          , Rd          , Gs          , Gs          , Ww          , Ss          , Ww          , Mm^Xm       , Mm^Xm       
Mm^Xm       , Mm^Xm       , Dd          , Dd^Vda      , Gs          , Gs          , Ww          , Ww^Bw\      , Ww^Bw\      , Ww          , Gs^Fp       , Mm^Xm       , Dd          , Dd^Vda      , Gs          , Gs          , Ww          , Ww^Bw\      , Ww^Bw\      , Ww          , Gs^Fp       , Mm^Xm       , Dd          , Dd^Vda      , Gs          , Gs          , Ww          , Ww^Bw\      , Ww^Bw\      , Ww          , Gs^Fp       , Mm^Xm       , Mm^Xm       
Mm^Xm       , Mm^Xm       , Gg          , Rd          , Hh          , Gg^Fet      , Ww          , Ww          , Re^Uf       , Gg          , Gg          , Mm^Xm       , Gg          , Rd          , Hh          , Gg^Fet      , Ww          , Ww          , Re^Uf       , Gg          , Gg          , Mm^Xm       , Gg          , Rd          , Hh          , Gg^Fet      , Ww          , Ww          , Re^Uf       , Gg          , Gg          , Mm^Xm       , Mm^Xm       
Mm^Xm       , Mm^Xm       , Gg         , Rd          , Gs          , Re^Uf       , Ww          , Ww          , Gg          , Re          , Uu^Vu       , Mm^Xm       , Gg         , Rd          , Gs          , Re^Uf       , Ww          , Ww          , Gg          , Re          , Uu^Vu       , Mm^Xm       , Gg         , Rd          , Gs          , Re^Uf       , Ww          , Ww          , Gg          , Re          , Uu^Vu       , Mm^Xm       , Mm^Xm       
Mm^Xm       , Mm^Xm       , Gg^Ve       , Rd          , Rd          , Ww          , Ww          , Ww          , Gg          , Uu          , Uu          , Mm^Xm       , Gg^Ve       , Rd          , Rd          , Ww          , Ww          , Ww          , Gg          , Uu          , Uu          , Mm^Xm       , Gg^Ve       , Rd          , Rd          , Ww          , Ww          , Ww          , Gg          , Uu          , Uu          , Mm^Xm       , Mm^Xm       
Mm^Xm       , Mm^Xm       , Chr         , Gg          , Gg         , Wwf         , Wwf         , Gs^Fp       , Gg          , Uu^Ii       , Rp          , Mm^Xm       , Chr         , Gg          , Gg         , Wwf         , Wwf         , Gs^Fp       , Gg          , Uu^Ii       , Rp          , Mm^Xm       , Chr         , Gg          , Gg         , Wwf         , Wwf         , Gs^Fp       , Gg          , Uu^Ii       , Rp          , Mm^Xm       , Mm^Xm       
Mm^Xm       , Mm^Xm       , 4 Khr       , Chr         , Chw         , Wwf         , Gg          , Uu^Uf       , Rp          , Rp          , Gg          , Mm^Xm       , 5 Khr       , Chr         , Chw         , Wwf         , Gg          , Uu^Uf       , Rp          , Rp          , Gg          , Mm^Xm       , 6 Khr       , Chr         , Chw         , Wwf         , Gg          , Uu^Uf       , Rp          , Rp          , Gg          , Mm^Xm       , Mm^Xm       
Mm^Xm       , Mm^Xm       , Qxu         , Chr         , Qxu         , Ww          , Qxu         , Gg          , Qxu         , Gg          , Qxu         , Mm^Xm       , Qxu         , Chr         , Qxu         , Ww          , Qxu         , Gg          , Qxu         , Gg          , Qxu         , Mm^Xm       , Qxu         , Chr         , Qxu         , Ww          , Qxu         , Gg          , Qxu         , Gg          , Qxu         , Mm^Xm       , Mm^Xm       
Qxu         , Qxu         , Qxu         , Qxu         , Qxu         , Qxu         , Qxu         , Qxu         , Qxu         , Qxu         , Qxu         , Qxu         , Qxu         , Qxu         , Qxu         , Qxu         , Qxu         , Qxu         , Qxu         , Qxu         , Qxu         , Qxu         , Qxu         , Qxu         , Qxu         , Qxu         , Qxu         , Qxu         , Qxu         , Qxu         , Qxu         , Qxu         , Qxu         
